;test
  #####
###   #
#.@o  #
### o.#
#.##o #
# # . ##
#o *oo.#
#   .  #  
########
